Overhang,Total,Correct,Mismatch,Fidelity,Number mismatch overhangs,Top 5 mismatch overhangs
AAAA,856,837,19,0.977803738317757,11,TTAT (26%); TTTG (16%); GTTT (11%); TGTT (11%); CTTT (5%)
AAAC,3510,3308,202,0.9424501424501425,18,GTTG (28%); GTTC (16%); GTAT (13%); GTTA (13%); GGTT (10%)
AAAG,2632,2480,152,0.9422492401215805,16,TTTT (28%); CTTG (16%); CTTC (15%); CTAT (11%); CTTA (11%)
AAAT,2156,1786,370,0.8283858998144712,18,GTTT (72%); TTTT (6%); ATTA (4%); ATAT (4%); ATTC (4%)
AACA,2987,2909,78,0.9738868429862738,11,GGTT (18%); TGAT (15%); TGTA (13%); TGTG (13%); CGTT (10%)
AACC,4073,3813,260,0.9361649889516327,20,GTTT (18%); GGTA (17%); GGGT (15%); GGTG (12%); GGTC (9%)
AACG,4197,3384,813,0.806290207290922,30,TGTT (55%); CGTG (9%); CGTC (7%); CGTA (7%); CTTT (5%)
AACT,3515,2871,644,0.8167852062588905,21,GGTT (53%); TGTT (31%); AGTC (3%); AGTG (2%); CGTT (2%)
AAGA,1604,1567,37,0.976932668329177,13,GCTT (27%); CCTT (11%); TCTA (11%); TATT (8%); TCGT (8%)
AAGC,3904,3662,242,0.9380122950819673,25,GCTG (21%); GGTT (20%); GCTC (13%); GTTT (9%); GCTA (8%)
AAGG,3421,3045,376,0.8900906167787197,26,TCTT (40%); CCTG (14%); CGTT (12%); CCTC (7%); CCTA (6%)
AAGT,2289,2023,266,0.8837920489296636,19,GCTT (77%); TCTT (6%); ACTG (3%); AGTT (2%); ATTT (2%)
AATA,1526,1462,64,0.9580602883355177,18,TGTT (22%); GATT (17%); TTTT (11%); AATT (9%); CATT (8%)
AATC,3042,2817,225,0.9260355029585798,19,GGTT (47%); GATC (8%); GATG (7%); GCTT (7%); GTTT (7%)
AATG,2833,2500,333,0.8824567596187787,35,TATT (35%); CATC (11%); CGTT (9%); CTTT (9%); CATG (8%)
AATT,1928,1754,174,0.9097510373443983,22,GATT (36%); TATT (29%); AAAT (5%); ATTT (4%); AATA (3%)
ACAA,1666,1607,59,0.9645858343337335,14,TTGG (31%); GTGT (10%); TTGC (10%); TGGT (8%); TTAT (7%)
ACAC,4340,3626,714,0.8354838709677419,18,GTGG (59%); GTGC (14%); GGGT (10%); GTGA (5%); GCGT (2%)
ACAG,4237,3548,689,0.837384942176068,26,CTGG (57%); CTGC (14%); TTGT (9%); CTGA (5%); CGGT (2%)
ACAT,3449,2835,614,0.8219773847492027,25,GTGT (70%); ATGG (13%); TTGT (5%); ATGC (4%); AGGT (2%)
ACCA,3822,3692,130,0.9659863945578231,16,TGGG (26%); GGGT (18%); TGGC (13%); CGGT (11%); TGGA (9%)
ACCC,3977,3634,343,0.9137540859944682,22,GGGG (54%); GGGC (16%); GTGT (7%); GGGA (5%); AGGT (3%)
ACCG,4862,3909,953,0.8039901275195392,28,TGGT (40%); CGGG (36%); CGGC (8%); CGGA (3%); AGGT (3%)
ACCT,4037,3372,665,0.8352737181075056,20,TGGT (47%); GGGT (29%); AGGG (9%); AGGC (7%); AGGA (3%)
ACGA,3156,3052,104,0.9670468948035488,17,TCGG (16%); TTGT (16%); GCGT (15%); TCGC (14%); ACGT (6%)
ACGC,4217,3681,536,0.8728954232866967,37,GCGG (29%); GGGT (19%); GCGC (15%); GTGT (8%); ACGT (5%)
ACGG,4614,3526,1088,0.7641959254442999,37,CCGG (31%); TCGT (28%); CCGC (14%); CTGT (5%); ACGT (4%)
ACGT,2928,2452,476,0.837431693989071,26,GCGT (57%); ACGG (9%); AGGT (6%); ATGT (6%); TCGT (6%)
ACTA,1784,1688,96,0.9461883408071748,16,TGGT (41%); GAGT (19%); TTGT (11%); TAGC (5%); TAGG (4%)
ACTC,3612,3022,590,0.8366555924695459,25,GGGT (58%); GAGG (13%); GAGC (7%); GTGT (7%); GCGT (4%)
ACTG,3077,2215,862,0.7198570035749107,31,CAGG (30%); CGGT (19%); TAGT (18%); CTGT (15%); CAGC (4%)
ACTT,2286,2023,263,0.8849518810148731,24,TAGT (37%); GAGT (25%); AGGT (6%); ATGT (6%); AAGG (4%)
AGAA,1802,1735,67,0.962819089900111,18,TTGT (22%); GTCT (13%); ATCT (9%); TGCT (9%); CTCT (7%)
AGAC,3831,3013,818,0.7864787261811538,26,GTGT (30%); GTCG (21%); GGCT (14%); GTTT (13%); GTCA (5%)
AGAG,3481,2924,557,0.8399885090491238,25,CTGT (25%); CTCG (19%); TTCT (16%); CTTT (13%); CTAT (7%)
AGAT,3645,2802,843,0.7687242798353909,29,GTCT (61%); ATGT (12%); ATCG (7%); TTCT (5%); ATTT (3%)
AGCA,3412,3076,336,0.9015240328253223,19,GGCT (28%); TGGT (23%); TGCG (12%); CGCT (7%); TGTT (7%)
AGCC,4072,3033,1039,0.7448428290766208,27,GGGT (29%); GGTT (16%); GGCG (13%); GTCT (8%); GGAT (7%)
AGCG,5027,2958,2069,0.5884225184006365,35,TGCT (43%); CGGT (13%); CGCG (13%); CGTT (6%); AGCT (5%)
AGCT,3834,2530,1304,0.6598852373500261,35,GGCT (42%); TGCT (29%); AGCG (8%); AGGT (8%); AGTT (3%)
AGGA,3073,2971,102,0.9668076797917344,18,GCCT (31%); ACCT (17%); TCGT (11%); TACT (8%); TTCT (7%)
AGGC,3971,3012,959,0.7584991186099219,25,GGCT (26%); GCTT (16%); GCGT (14%); GCCG (10%); GTCT (8%)
AGGG,3724,2543,1181,0.6828678839957035,31,TCCT (43%); CCTT (11%); CCGT (9%); CGCT (7%); CCCG (6%)
AGGT,4195,3372,823,0.8038140643623362,29,GCCT (57%); AGCT (12%); TCCT (9%); ACCG (4%); ACGT (4%)
AGTA,2767,2605,162,0.9414528370075894,19,GACT (36%); TGCT (25%); AACT (7%); CACT (4%); TTCT (4%)
AGTC,3747,3075,672,0.8206565252201762,23,GGCT (52%); GATT (9%); GACG (7%); GAGT (7%); TACT (6%)
AGTG,2820,2245,575,0.7960992907801419,27,TACT (28%); CGCT (14%); CACG (11%); CATT (11%); CTCT (9%)
AGTT,3361,2871,490,0.8542100565307944,24,TACT (41%); GACT (31%); AGCT (9%); CACT (4%); AACC (2%)
ATAA,718,676,42,0.9415041782729805,12,TGAT (21%); TAAT (17%); GTAT (14%); ATAT (12%); TTTT (12%)
ATAC,3419,3033,386,0.8871014916642294,23,GGAT (27%); GTGT (26%); GTTT (13%); GAAT (10%); GTAG (5%)
ATAG,2743,2454,289,0.8946409041195771,29,CTGT (29%); CTTT (29%); TTAT (10%); CTAG (4%); CGAT (3%)
ATAT,1683,1510,173,0.8972073677956031,31,GTAT (21%); AGAT (13%); ATTT (12%); TTAT (11%); AAAT (8%)
ATCA,2904,2754,150,0.9483471074380165,19,GGAT (37%); TGGT (14%); AGAT (7%); TGAG (7%); TGCT (7%)
ATCC,3874,3554,320,0.9173980382034074,27,GGGT (42%); GGTT (10%); GGAG (8%); GGAC (6%); TGAT (6%)
ATCG,4325,3531,794,0.8164161849710982,32,TGAT (52%); CGGT (12%); CGAG (8%); AGAT (7%); CGTT (5%)
ATCT,3312,2802,510,0.8460144927536232,32,TGAT (46%); GGAT (30%); AGGT (5%); AGAC (3%); AGAG (3%)
ATGA,2180,2055,125,0.9426605504587156,28,GCAT (26%); TCGT (18%); TTAT (13%); ACAT (8%); TGAT (6%)
ATGC,3878,3153,725,0.8130479628674575,34,GCGT (38%); GGAT (26%); GTAT (10%); GCTT (5%); ACAT (4%)
ATGG,3219,2554,665,0.7934141037589314,36,TCAT (29%); CCGT (14%); ACAT (12%); CCTT (9%); CCAG (6%)
ATGT,3199,2835,364,0.8862144420131292,37,AGAT (27%); GCAT (26%); TCAT (12%); ACGT (8%); ACTT (4%)
ATTA,1580,1450,130,0.9177215189873418,16,TGAT (31%); GAAT (20%); AAAT (12%); CAAT (12%); TTAT (9%)
ATTC,3356,2861,495,0.8525029797377831,31,GGAT (54%); GAGT (8%); GTAT (8%); GATT (6%); TAAT (5%)
ATTG,3029,2526,503,0.8339385935952459,37,TAAT (29%); CGAT (22%); CATT (16%); CTAT (8%); GAAT (4%)
ATTT,2061,1786,275,0.8665696263949539,17,TAAT (36%); GAAT (29%); AGAT (10%); ATAT (8%); CAAT (3%)
CAAA,1920,1850,70,0.9635416666666666,21,GTTG (23%); TTCG (10%); TGCG (9%); TTGG (7%); ATTG (6%)
CAAC,3736,3471,265,0.92906852248394,22,GGTG (30%); GTTT (13%); GATG (12%); GTCG (8%); GTTA (8%)
CAAG,2577,2226,351,0.8637951105937136,25,TTTG (45%); GTTG (13%); CTAG (7%); CTTT (7%); ATTG (5%)
CAAT,3000,2526,474,0.842,27,GTTG (69%); TTTG (8%); AATG (3%); ATTA (3%); ATCG (3%)
CACA,3862,3497,365,0.9054893837389953,19,GGTG (57%); TGGG (13%); AGTG (7%); CGTG (7%); TGCG (6%)
CACC,3914,3403,511,0.8694430250383239,28,GGGG (32%); GGCG (18%); GGTT (8%); GTTG (8%); GGTA (7%)
CACG,4351,3092,1259,0.7106412319007125,33,TGTG (57%); CGGG (9%); AGTG (5%); GGTG (5%); CGCG (4%)
CACT,3589,2245,1344,0.625522429646141,33,GGTG (48%); TGTG (35%); AGCG (5%); AGGG (3%); CGTG (2%)
CAGA,3008,2862,146,0.9514627659574468,19,GCTG (45%); ACTG (16%); CCTG (6%); TTTG (5%); TCGG (4%)
CAGC,3977,3478,499,0.874528539099824,30,GGTG (38%); GTTG (16%); GATG (8%); ACTG (7%); GCTT (7%)
CAGG,3826,2906,920,0.759539989545217,27,TCTG (47%); ACTG (28%); CGTG (5%); CCAG (4%); CCTT (3%)
CAGT,2572,2215,357,0.8611975116640747,23,GCTG (63%); TCTG (11%); AGTG (10%); ATTG (3%); ACCG (2%)
CATA,2749,2418,331,0.8795925791196799,25,GATG (37%); TGTG (30%); AATG (7%); TTTG (7%); CATG (4%)
CATC,4414,3201,1213,0.7251925690983235,34,GGTG (61%); GTTG (14%); TATG (6%); GACG (4%); AATG (3%)
CATG,3760,2742,1018,0.7292553191489362,41,TATG (32%); CGTG (30%); CTTG (10%); GATG (5%); CATT (3%)
CATT,3348,2500,848,0.7467144563918757,35,GATG (44%); TATG (25%); ATTG (9%); AGTG (7%); CATG (4%)
CCAA,2697,2609,88,0.9673711531331108,16,GTGG (25%); TGGG (10%); ATGG (9%); TAGG (9%); TCGG (9%)
CCAC,3536,3055,481,0.8639705882352942,23,GGGG (56%); GAGG (9%); GCGG (9%); GTGA (4%); ATGG (4%)
CCAG,3464,3063,401,0.8842378752886836,31,TTGG (40%); ATGG (11%); CGGG (10%); CAGG (9%); GTGG (7%)
CCAT,3032,2554,478,0.8423482849604221,21,GTGG (67%); TTGG (11%); AGGG (8%); CATG (3%); AAGG (2%)
CCCA,3201,2996,205,0.9359575132771009,18,GGGG (47%); AGGG (16%); CGGG (12%); TGTG (6%); CTGG (5%)
CCCC,2412,2214,198,0.917910447761194,17,GGTG (22%); TGGG (18%); CGGG (12%); GAGG (8%); GGGA (7%)
CCCG,3191,2402,789,0.7527420871200251,18,TGGG (73%); AGGG (10%); CGTG (4%); GGGG (3%); CGGA (2%)
CCCT,3420,2543,877,0.7435672514619883,24,TGGG (48%); GGGG (42%); CGGG (3%); AGTG (2%); ACGG (1%)
CCGA,3509,3182,327,0.9068110572812768,26,GCGG (33%); TTGG (29%); ACGG (12%); CCGG (6%); TCTG (5%)
CCGC,3185,2406,779,0.7554160125588697,26,GTGG (40%); ACGG (20%); GGGG (20%); GCTG (6%); GAGG (3%)
CCGG,4429,2944,1485,0.6647098667870851,35,TCGG (49%); ACGG (23%); CTGG (13%); GCGG (3%); CGGG (2%)
CCGT,4461,3526,935,0.790405738623627,22,GCGG (54%); TCGG (17%); AGGG (11%); ATGG (10%); CCGG (2%)
CCTA,2463,2077,386,0.8432805521721478,24,TGGG (27%); GAGG (22%); TTGG (12%); ATGG (8%); ACGG (8%)
CCTC,3409,2425,984,0.7113523027280727,28,GGGG (63%); GTGG (15%); GCGG (5%); TAGG (4%); GATG (3%)
CCTG,4025,2906,1119,0.7219875776397515,32,CGGG (37%); TAGG (24%); CTGG (18%); AAGG (5%); GAGG (3%)
CCTT,3916,3045,871,0.7775791624106231,27,GAGG (33%); TAGG (30%); AGGG (15%); ATGG (7%); CAGG (3%)
CGAA,2993,2867,126,0.9579017707985299,22,GTCG (34%); ATCG (10%); TTTG (10%); TGCG (9%); TTGG (6%)
CGAC,3919,2814,1105,0.7180403164072467,29,GTTG (41%); GGCG (26%); GACG (5%); GTGG (5%); GTCA (5%)
CGAG,3275,2338,937,0.7138931297709924,33,TTCG (30%); CTTG (26%); ATCG (7%); GTCG (6%); CTGG (6%)
CGAT,4650,3531,1119,0.7593548387096775,33,GTCG (62%); ATTG (10%); TTCG (9%); AGCG (7%); AACG (3%)
CGCA,3444,2907,537,0.8440766550522648,21,GGCG (44%); AGCG (12%); TGTG (11%); CGCG (10%); TGGG (9%)
CGCC,3473,2243,1230,0.6458393319896343,30,GGTG (35%); GGGG (18%); GTCG (10%); GACG (6%); TGCG (6%)
CGCG,4246,1914,2332,0.45077720207253885,47,TGCG (51%); CGTG (13%); AGCG (12%); CGGG (5%); GGCG (4%)
CGCT,4750,2958,1792,0.6227368421052631,38,TGCG (40%); GGCG (40%); AGTG (4%); AGGG (4%); CGCG (2%)
CGGA,3663,3282,381,0.895986895986896,26,GCCG (47%); TTCG (13%); ACCG (8%); TCTG (7%); TGCG (5%)
CGGC,4107,2480,1627,0.6038470903335769,30,GCTG (30%); GGCG (22%); GTCG (18%); GACG (12%); ACCG (5%)
CGGG,4513,2402,2111,0.5322401949922446,40,TCCG (36%); CCTG (19%); ACCG (16%); CTCG (6%); CACG (6%)
CGGT,5495,3909,1586,0.7113739763421292,38,GCCG (44%); AGCG (17%); TCCG (13%); ACTG (11%); ATCG (6%)
CGTA,4040,3499,541,0.8660891089108911,32,GACG (39%); TGCG (23%); AACG (10%); CACG (7%); TAGG (5%)
CGTC,4321,2962,1359,0.6854894700300856,30,GGCG (45%); GATG (16%); GAGG (9%); TACG (7%); GTCG (5%)
CGTG,4731,3092,1639,0.653561614880575,43,TACG (32%); CATG (19%); CGCG (18%); CTCG (7%); GACG (5%)
CGTT,4586,3384,1202,0.7378979502834714,33,GACG (35%); TACG (34%); AGCG (11%); AAGG (4%); ATCG (3%)
CTAA,1173,1079,94,0.9198635976129582,22,GTAG (24%); TCAG (13%); TTTG (11%); TTCG (10%); TTGG (9%)
CTAC,3688,3050,638,0.8270065075921909,28,GGAG (32%); GTTG (24%); GTGG (21%); GAAG (9%); GCAG (4%)
CTAG,1976,1562,414,0.7904858299595142,31,CTTG (27%); CTGG (25%); TTAG (10%); CGAG (7%); CAAG (6%)
CTAT,2760,2454,306,0.8891304347826087,30,GTAG (25%); ATTG (14%); TTAG (13%); AGAG (12%); ATGG (8%)
CTCA,3021,2606,415,0.8626282687851705,22,GGAG (34%); TGTG (16%); TGGG (13%); TGCG (12%); CGAG (9%)
CTCC,3098,2351,747,0.7588766946417044,19,GGTG (49%); GGGG (21%); GGCG (12%); TGAG (5%); GAAG (3%)
CTCG,3206,2338,868,0.7292576419213974,28,TGAG (41%); CGGG (15%); CGTG (13%); AGAG (12%); CGCG (7%)
CTCT,3979,2924,1055,0.7348580045237497,29,GGAG (43%); TGAG (33%); AGCG (6%); AGTG (5%); AGGG (4%)
CTGA,2958,2508,450,0.847870182555781,29,GCAG (42%); TCTG (12%); TTAG (11%); ACAG (8%); CCAG (5%)
CTGC,4290,2931,1359,0.6832167832167833,34,GCTG (28%); GTAG (19%); GCGG (18%); GGAG (18%); ACAG (7%)
CTGG,4542,3063,1479,0.6743725231175693,37,TCAG (27%); ACAG (27%); CCTG (13%); CCGG (13%); CTAG (7%)
CTGT,4544,3548,996,0.7808098591549296,37,GCAG (40%); AGAG (14%); ACTG (13%); TCAG (11%); ATAG (8%)
CTTA,1876,1581,295,0.8427505330490405,33,GAAG (30%); TGAG (21%); TTAG (7%); CAAG (6%); TACG (6%)
CTTC,3702,2633,1069,0.711237169097785,37,GGAG (49%); GTAG (17%); GATG (11%); GACG (6%); GAGG (4%)
CTTG,3046,2226,820,0.7307944845699278,33,CGAG (30%); TAAG (21%); CTAG (13%); CATG (12%); CACG (5%)
CTTT,3242,2480,762,0.7649599012954966,32,GAAG (30%); TAAG (21%); ATAG (11%); AGAG (10%); AACG (5%)
GAAA,2145,2068,77,0.9641025641025641,18,TTTT (18%); TTAC (13%); TATC (12%); TTTG (9%); GTTC (8%)
GAAC,3751,2908,843,0.7752599306851506,30,GTTT (45%); GTTA (18%); GTAC (7%); GTTG (6%); GGTC (5%)
GAAG,3323,2633,690,0.7923563045440867,33,CTTT (33%); TTTC (23%); CTTA (13%); CTAC (8%); CTGC (4%)
GAAT,3844,2861,983,0.7442767950052029,37,GTTC (66%); ATTT (8%); TTTC (8%); ATAC (4%); ATTA (3%)
GACA,3846,3490,356,0.907436297451898,23,GGTC (25%); TGTT (24%); TGGC (17%); CGTC (8%); TGTA (8%)
GACC,4061,2723,1338,0.6705245013543463,34,GGTT (43%); GGTA (13%); GGGC (13%); GGCC (9%); GTTC (6%)
GACG,5143,2962,2181,0.5759284464320436,45,TGTC (40%); CGTT (19%); CGTA (10%); CGGC (9%); CGTG (4%)
GACT,4953,3075,1878,0.6208358570563295,38,GGTC (44%); TGTC (30%); AGTT (8%); AGGC (4%); AGTA (3%)
GAGA,2959,2826,133,0.9550523825616762,18,GCTC (23%); TCTT (23%); TTTC (11%); TGTC (10%); ACTC (6%)
GAGC,4198,3112,1086,0.74130538351596,34,GCTT (42%); GGTC (15%); GCTA (12%); GTTC (6%); ACTC (4%)
GAGG,3848,2425,1423,0.6301975051975052,32,TCTC (42%); CCTT (20%); CGTC (9%); CCTA (6%); ACTC (5%)
GAGT,4079,3022,1057,0.7408678597695514,32,GCTC (67%); TCTC (9%); ACTT (6%); AGTC (4%); ATTC (4%)
GATA,3142,2930,212,0.9325270528325907,33,TGTC (24%); GATC (23%); CATC (9%); TATT (6%); AATC (5%)
GATC,3874,2764,1110,0.7134744450180692,39,GGTC (36%); GATT (32%); GATA (4%); GTTC (4%); TATC (4%)
GATG,4696,3201,1495,0.6816439522998297,46,TATC (26%); CATT (25%); CGTC (14%); CATA (8%); CTTC (8%)
GATT,3689,2817,872,0.7636215776633234,39,GATC (41%); TATC (27%); AATT (7%); AGTC (7%); ATTC (4%)
GCAA,2983,2888,95,0.9681528662420382,18,TTGT (42%); TGGC (8%); TTGA (8%); GTGC (7%); CTGC (4%)
GCAC,3860,2608,1252,0.6756476683937824,29,GTGT (40%); GGGC (20%); GTGA (18%); GTGG (5%); GCGC (4%)
GCAG,4048,2931,1117,0.7240612648221344,40,CTGT (35%); TTGC (25%); CTGA (17%); CTGG (4%); CGGC (3%)
GCAT,4654,3153,1501,0.677481736140954,30,GTGC (75%); ATGT (6%); TTGC (6%); AGGC (3%); ATGA (2%)
GCCA,4161,3145,1016,0.7558279259793319,19,TGGT (74%); GGGC (12%); CGGC (2%); TGGA (2%); AGGC (2%)
GCCC,3857,2088,1769,0.5413533834586466,32,GGGT (77%); GGGA (7%); GTGC (2%); GGTC (2%); TGGC (2%)
GCCG,4626,2480,2146,0.5361003026372676,39,TGGC (41%); CGGT (32%); CGGA (8%); AGGC (5%); CTGC (2%)
GCCT,5236,3012,2224,0.5752482811306341,36,GGGC (35%); TGGC (32%); AGGT (21%); TGGT (3%); AGGA (1%)
GCGA,3316,2764,552,0.8335343787696019,32,TCGT (47%); TTGC (18%); GCGC (10%); ACGC (4%); TGGC (4%)
GCGC,4019,2180,1839,0.5424234884299577,38,GCGT (55%); GTGC (13%); GGGC (10%); ACGC (4%); GCTC (4%)
GCGG,4675,2406,2269,0.5146524064171123,52,TCGC (40%); CCGT (22%); CTGC (11%); ACGC (7%); CCGA (5%)
GCGT,5673,3681,1992,0.6488630354309889,38,GCGC (50%); ATGC (14%); ACGT (14%); TCGC (7%); AGGC (7%)
GCTA,3721,3220,501,0.8653587745229777,26,GAGC (27%); TAGT (23%); TGGC (23%); AAGC (4%); ACGC (4%)
GCTC,4877,3112,1765,0.6380971908960427,39,GAGT (40%); GGGC (36%); GTGC (5%); TAGC (4%); GCGC (4%)
GCTG,5403,3478,1925,0.6437164538219508,51,CGGC (26%); TAGC (24%); CTGC (20%); CAGT (12%); CAGA (3%)
GCTT,5123,3662,1461,0.7148155377708374,40,GAGC (31%); TAGC (30%); AAGT (14%); AGGC (11%); ATGC (3%)
GGAA,3474,3267,207,0.9404145077720207,26,TTGC (23%); TTTC (15%); TTCT (13%); TTAC (8%); TACC (7%)
GGAC,4803,2374,2429,0.4942744118259421,36,GTTC (26%); GTCT (21%); GTGC (15%); GTCA (9%); GTAC (9%)
GGAG,4428,2351,2077,0.5309394760614273,38,CTTC (25%); CTCT (22%); TTCC (15%); CTGC (11%); CTAC (10%)
GGAT,5857,3554,2303,0.6067952876899436,42,GTCC (53%); ATTC (12%); ATGC (8%); ATCT (7%); TTCC (5%)
GGCA,4680,3011,1669,0.6433760683760684,31,TGCT (42%); GGCC (14%); TGGC (13%); TGTC (9%); TGAC (6%)
GGCC,5247,2164,3083,0.41242614827520485,45,GGCT (36%); GGTC (18%); GGGC (12%); GGCA (8%); GGAC (7%)
GGCG,6037,2243,3794,0.37154215670034785,46,TGCC (26%); CGCT (19%); CGTC (16%); CGGC (9%); CGAC (8%)
GGCT,6645,3033,3612,0.4564334085778781,44,GGCC (31%); TGCC (23%); AGCT (15%); AGTC (10%); AGGC (7%)
GGGA,3172,2641,531,0.8325977301387137,30,TCCT (27%); GCCC (24%); TTCC (13%); TCTC (8%); TGCC (5%)
GGGC,4988,2088,2900,0.4186046511627907,36,GCCT (27%); GCTC (22%); GGCC (13%); GCAC (9%); GTCC (7%)
GGGG,5278,2214,3064,0.41947707464948847,47,TCCC (23%); CCTC (20%); CCCT (12%); CCAC (9%); CGCC (7%)
GGGT,6498,3634,2864,0.559248999692213,54,GCCC (48%); ACTC (12%); AGCC (11%); ACCT (7%); TCCC (5%)
GGTA,4412,3743,669,0.8483680870353582,35,GACC (26%); TACT (25%); TGCC (14%); AACC (6%); TATC (6%)
GGTC,5101,2723,2378,0.5338168986473241,36,GACT (35%); GGCC (24%); GATC (17%); GAGC (7%); GACA (4%)
GGTG,6978,3403,3575,0.4876755517340212,53,CATC (21%); CACT (18%); TACC (16%); CGCC (12%); CTCC (10%)
GGTT,5678,3813,1865,0.6715392743923917,42,GACC (31%); TACC (22%); AACT (18%); AGCC (9%); AATC (6%)
GTAA,2029,1932,97,0.9521931986200098,25,TTAT (18%); TGAC (12%); TAAC (10%); TTCC (9%); TTGC (7%)
GTAC,3321,2480,841,0.7467630231857875,38,GTGC (27%); GGAC (25%); GTAT (17%); GAAC (7%); GTTC (7%)
GTAG,3845,3050,795,0.7932379713914174,45,CTGC (32%); CTTC (23%); TTAC (10%); CTAT (10%); CGAC (4%)
GTAT,3521,3033,488,0.8614030105083783,42,GTAC (30%); ATGC (15%); TTAC (9%); ATTC (8%); AGAC (8%)
GTCA,3796,2860,936,0.7534246575342466,27,TGAT (49%); GGAC (24%); CGAC (6%); AGAC (5%); TGGC (4%)
GTCC,4250,2374,1876,0.5585882352941176,36,GGAT (65%); GGGC (11%); GGCC (7%); GGTC (4%); TGAC (3%)
GTCG,5291,2814,2477,0.5318465318465319,44,TGAC (31%); CGAT (28%); CGGC (12%); AGAC (7%); CGCC (5%)
GTCT,5066,3013,2053,0.594749309119621,38,TGAC (32%); AGAT (25%); GGAC (25%); AGCC (4%); AGGC (4%)
GTGA,4091,3421,670,0.836225861647519,36,TCAT (33%); GCAC (33%); TTAC (10%); ACAC (5%); TCGC (3%)
GTGC,4957,2608,2349,0.5261246721807545,40,GCAT (48%); GGAC (16%); GCGC (11%); GTAC (10%); ACAC (4%)
GTGG,5336,3055,2281,0.5725262368815592,59,TCAC (29%); ACAC (18%); CCAT (14%); CCGC (14%); CCTC (7%)
GTGT,5293,3626,1667,0.6850557339882865,43,GCAC (30%); ACAT (26%); AGAC (15%); TCAC (9%); ATAC (6%)
GTTA,3276,2770,506,0.8455433455433455,31,GAAC (30%); TAAT (25%); TGAC (18%); AAAC (5%); CAAC (4%)
GTTC,4668,2908,1760,0.6229648671808055,35,GAAT (37%); GGAC (37%); TAAC (4%); GACC (4%); GAGC (4%)
GTTG,5367,3471,1896,0.6467300167691448,55,CGAC (24%); TAAC (19%); CAAT (17%); CATC (9%); CTAC (8%)
GTTT,4629,3308,1321,0.7146251890257075,42,GAAC (29%); TAAC (24%); AAAT (20%); AGAC (8%); ATAC (4%)
TAAA,331,289,42,0.8731117824773413,9,TTTG (48%); TTTT (24%); TTTC (14%); CTTA (2%); GTTA (2%)
TAAC,3595,2770,825,0.7705146036161336,23,GTTG (44%); GTTT (38%); GTTC (9%); GGTA (1%); GTCA (1%)
TAAG,2013,1581,432,0.7853949329359166,27,CTTG (40%); CTTT (38%); CTTC (7%); TTTA (5%); CTAA (2%)
TAAT,1910,1450,460,0.7591623036649214,25,ATTG (31%); GTTA (28%); ATTT (21%); ATTC (6%); TTTA (2%)
TACA,2056,1825,231,0.8876459143968871,17,TGTG (43%); TGTT (36%); TGTC (6%); GGTA (3%); TGCA (3%)
TACC,4894,3743,1151,0.7648140580302412,24,GGTG (50%); GGTT (35%); GGTC (6%); GGCA (2%); GGGA (1%)
TACG,4793,3499,1294,0.7300229501356145,35,CGTG (41%); CGTT (31%); TGTA (12%); CGTC (8%); CGCA (2%)
TACT,3321,2605,716,0.7844022884673291,38,AGTT (28%); GGTA (23%); AGTG (22%); TGTA (8%); AGTC (6%)
TAGA,717,629,88,0.8772663877266388,18,TCTG (36%); TCTT (25%); TCTC (10%); TATA (6%); TGTA (3%)
TAGC,4282,3220,1062,0.7519850537132181,33,GCTG (43%); GCTT (41%); GCTC (7%); GGTA (2%); GTTA (1%)
TAGG,2803,2077,726,0.7409917945058866,31,CCTG (36%); CCTT (36%); TCTA (8%); CCTC (6%); CGTA (4%)
TAGT,2143,1688,455,0.7876808212785814,28,ACTG (34%); GCTA (26%); ACTT (22%); ACTC (4%); GCTT (3%)
TATA,602,488,114,0.8106312292358804,20,TATG (39%); TATT (25%); GATA (5%); TGTA (5%); TAGA (4%)
TATC,3698,2930,768,0.7923201730665225,30,GATG (51%); GATT (30%); GATC (6%); GGTA (5%); GAAA (1%)
TATG,3150,2418,732,0.7676190476190476,27,CATG (45%); CATT (29%); CATC (10%); TATA (6%); CGTA (3%)
TATT,1717,1462,255,0.8514851485148515,25,AATG (45%); AATT (20%); TATA (11%); AATC (5%); GATA (5%)
TCAA,683,626,57,0.9165446559297218,10,TTGG (68%); TTGT (9%); CTGA (5%); TCGA (5%); TTGC (4%)
TCAC,4331,3421,910,0.7898868621565458,25,GTGG (74%); GTGT (17%); GGGA (3%); GTGC (1%); GCGA (1%)
TCAG,3116,2508,608,0.8048780487804879,28,CTGG (66%); CTGT (17%); TTGA (4%); CTGC (2%); CTAA (2%)
TCAT,2581,2055,526,0.7962030220844634,23,GTGA (42%); ATGG (37%); ATGT (8%); TTGA (3%); GTGT (2%)
TCCA,2590,2212,378,0.8540540540540541,15,TGGG (81%); TGGT (10%); GGGA (2%); TGGC (1%); CGGA (1%)
TCCC,3549,2641,908,0.744153282614821,24,GGGG (76%); GGGT (16%); GGTA (1%); GTGA (1%); GGGC (1%)
TCCG,4506,3282,1224,0.7283621837549934,35,CGGG (62%); CGGT (17%); TGGA (12%); CGGC (1%); TGGG (1%)
TCCT,3853,2971,882,0.7710874643135219,33,AGGG (58%); GGGA (16%); TGGA (9%); AGGT (8%); TGGG (2%)
TCGA,1521,1314,207,0.863905325443787,29,TCGG (70%); TCGT (7%); TTGA (3%); GCGA (2%); ACGA (1%)
TCGC,3954,2764,1190,0.6990389479008599,27,GCGG (76%); GCGT (12%); GTGA (2%); GCTA (1%); GGGA (1%)
TCGG,4340,3182,1158,0.7331797235023041,32,CCGG (62%); CCGT (14%); TCGA (12%); CTGA (2%); ACGA (1%)
TCGT,3766,3052,714,0.8104089219330854,34,ACGG (43%); GCGA (36%); ACGT (4%); ATGA (3%); TCGA (2%)
TCTA,741,629,112,0.8488529014844804,20,TAGG (54%); TAGT (11%); GAGA (4%); TGGA (4%); AAGA (4%)
TCTC,3662,2826,836,0.7717094483888586,28,GAGG (72%); GAGT (12%); GGGA (5%); GCGA (2%); GAGC (2%)
TCTG,3534,2862,672,0.8098471986417657,40,CAGG (64%); CTGA (8%); CAGT (6%); TAGA (5%); CGGA (4%)
TCTT,1843,1567,276,0.850244167118828,31,AAGG (54%); GAGA (11%); TAGA (8%); AAGT (5%); GAGG (3%)
TGAA,1236,1114,122,0.901294498381877,23,TTCG (46%); TTCT (21%); TTTA (6%); CTCA (4%); ATCA (2%)
TGAC,4657,2860,1797,0.6141292677689499,35,GTCG (43%); GTCT (37%); GGCA (6%); GTTA (5%); GTCC (3%)
TGAG,3607,2606,1001,0.722484058774605,45,CTCG (36%); CTCT (35%); CTTA (6%); TTCA (6%); CTCC (3%)
TGAT,4090,2754,1336,0.6733496332518337,39,GTCA (34%); ATCG (31%); ATCT (17%); GTCT (3%); ATTA (3%)
TGCA,3459,2598,861,0.751084128360798,26,TGCG (58%); TGCT (24%); GGCA (6%); TGTA (3%); AGCA (1%)
TGCC,5186,3011,2175,0.5806016197454685,34,GGCG (46%); GGCT (39%); GGTA (4%); GGCC (3%); GTCA (2%)
TGCG,5812,2907,2905,0.5001720578114246,44,CGCG (41%); CGCT (25%); TGCA (17%); CGTA (4%); CGCC (3%)
TGCT,5477,3076,2401,0.5616213255431806,39,AGCG (37%); GGCA (29%); AGCT (16%); TGCA (9%); GGCT (2%)
TGGA,2517,2212,305,0.878823996821613,25,TCCG (47%); TCCT (25%); GCCA (8%); ACCA (4%); TGCA (3%)
TGGC,5360,3145,2215,0.5867537313432836,34,GCCG (39%); GCCT (33%); GGCA (10%); GCTA (5%); GACA (3%)
TGGG,4771,2996,1775,0.6279605952630476,40,CCCG (32%); CCCT (24%); TCCA (17%); CCTA (6%); CTCA (3%)
TGGT,5500,3692,1808,0.6712727272727272,42,GCCA (42%); ACCG (21%); ACCT (17%); AGCA (4%); GCCT (4%)
TGTA,2132,1825,307,0.8560037523452158,21,TACG (49%); TACT (19%); GACA (9%); TGCA (7%); AACA (3%)
TGTC,5273,3490,1783,0.661862317466338,25,GACG (49%); GACT (32%); GGCA (9%); GATA (3%); GACC (2%)
TGTG,5145,3497,1648,0.6796890184645287,41,CACG (44%); CACT (28%); CATA (6%); TACA (6%); CTCA (4%)
TGTT,3838,2909,929,0.7579468473163106,39,AACG (48%); AACT (21%); GACA (9%); TACA (9%); AGCA (2%)
TTAA,126,102,24,0.8095238095238095,10,TTAG (17%); TTAT (17%); TTGA (17%); TTTT (17%); GTAA (8%)
TTAC,2203,1932,271,0.8769859282796187,28,GTAG (30%); GTGA (24%); GTAT (17%); GGAA (6%); GTTA (5%)
TTAG,1307,1079,228,0.8255547054322877,29,CTGA (22%); CTAG (18%); CTAT (18%); CTTA (10%); CTTT (9%)
TTAT,809,676,133,0.8355995055624228,23,ATAG (22%); ATAT (14%); GTAA (13%); ATGA (12%); ATTA (9%)
TTCA,1244,1114,130,0.8954983922829582,20,TGAG (48%); TGAT (19%); GGAA (5%); TGGA (5%); TGGG (3%)
TTCC,3869,3267,602,0.8444042388214009,28,GGAG (51%); GGAT (21%); GGGA (11%); GGTA (4%); GGCA (2%)
TTCG,3461,2867,594,0.8283733025137243,32,CGAG (47%); CGAT (17%); TGAA (9%); CGGA (8%); CGTA (3%)
TTCT,1973,1735,238,0.8793715154586923,23,AGAG (37%); AGAT (18%); GGAA (11%); TGAA (11%); AGAC (3%)
TTGA,720,626,94,0.8694444444444445,25,TCAG (27%); TCAT (17%); GCAA (9%); TCGA (7%); CCAA (4%)
TTGC,3510,2888,622,0.8227920227920228,32,GCAG (45%); GCGA (16%); GCAT (14%); GGAA (8%); GCTA (3%)
TTGG,3129,2609,520,0.83381271971876,39,CCAG (31%); CCGA (18%); CCAT (10%); CCTA (9%); TCAA (8%)
TTGT,1854,1607,247,0.8667745415318231,31,ACAG (26%); GCAA (16%); ACAT (12%); ACGA (7%); AGAA (6%)
TTTA,343,289,54,0.8425655976676385,16,TAAG (37%); TAAT (20%); TGAA (13%); GAAA (6%); CAAA (4%)
TTTC,2429,2068,361,0.8513791683820502,29,GAAG (45%); GAAT (22%); GGAA (9%); GAGA (4%); GAAC (3%)
TTTG,2193,1850,343,0.84359325125399,36,CAAG (46%); CAAT (11%); CATA (7%); TAAA (6%); CGAA (4%)
TTTT,979,837,142,0.8549540347293156,28,AAAG (30%); AAAT (15%); GAAA (10%); TAAA (7%); AATA (5%)
